{
  "solidTiles": [2, 1, 16],
  "start": [1, 0],
  "finish": [29],
  "data": [
    [2, 33, 33, 2, 2, 2, 2, 2, 2, 2, 2, 2, 2, 2, 2, 2, 2, 2, 2, 2, 2, 2, 2, 2, 2, 2, 2, 2, 2, 2, 2],
    [2, 33, 33, 33, 33, 33, 33, 33, 33, 33, 33, 33, 33, 33, 33, 33, 33, 33, 2, 33, 33, 33, 33, 33, 33, 33, 33, 2, 33, 33, 2],
    [2, 33, 33, 33, 33, 33, 33, 33, 33, 33, 33, 33, 33, 33, 33, 33, 33, 33, 2, 33, 33, 33, 33, 33, 33, 33, 33, 2, 33, 33, 2],
    [2, 33, 33, 2, 33, 33, 2, 2, 2, 2, 2, 2, 2, 2, 2, 2, 33, 33, 2, 33, 33, 2, 33, 33, 2, 33, 33, 2, 33, 33, 2],
    [2, 33, 33, 2, 33, 33, 2, 33, 33, 33, 33, 33, 33, 33, 33, 33, 33, 33, 2, 33, 33, 2, 33, 33, 2, 33, 33, 2, 33, 33, 2],
    [2, 33, 33, 2, 33, 33, 2, 33, 33, 33, 33, 33, 33, 33, 33, 33, 33, 33, 2, 33, 33, 2, 33, 33, 2, 33, 33, 2, 33, 33, 2],
    [2, 33, 33, 2, 33, 33, 2, 2, 2, 2, 33, 33, 2, 2, 2, 2, 2, 2, 2, 2, 2, 2, 33, 33, 2, 33, 33, 2, 33, 33, 2],
    [2, 33, 33, 2, 33, 33, 33, 33, 33, 2, 33, 33, 33, 33, 33, 33, 33, 33, 33, 33, 33, 33, 33, 33, 2, 33, 33, 33, 33, 33, 2],
    [2, 33, 33, 2, 33, 33, 33, 33, 33, 2, 33, 33, 33, 33, 33, 33, 33, 33, 33, 33, 33, 33, 33, 33, 2, 33, 33, 33, 33, 33, 2],
    [2, 2, 2, 2, 2, 2, 2, 33, 33, 2, 2, 2, 2, 2, 2, 2, 2, 2, 2, 2, 2, 2, 2, 2, 2, 2, 2, 2, 33, 33, 2],
    [2, 33, 33, 33, 33, 33, 2, 33, 33, 33, 33, 33, 33, 33, 33, 2, 33, 33, 33, 33, 33, 33, 33, 33, 33, 33, 33, 33, 33, 33, 2],
    [2, 33, 33, 33, 33, 33, 2, 33, 33, 33, 33, 33, 33, 33, 33, 2, 33, 33, 33, 33, 33, 33, 33, 33, 33, 33, 33, 33, 33, 33, 2],
    [2, 33, 33, 2, 33, 33, 2, 2, 2, 2, 2, 2, 2, 33, 33, 2, 2, 2, 2, 33, 33, 2, 2, 2, 2, 2, 2, 2, 2, 2, 2],
    [2, 33, 33, 2, 33, 33, 33, 33, 33, 33, 33, 33, 2, 33, 33, 33, 33, 33, 2, 33, 33, 33, 33, 33, 33, 33, 33, 33, 33, 33, 2],
    [2, 33, 33, 2, 33, 33, 33, 33, 33, 33, 33, 33, 2, 33, 33, 33, 33, 33, 2, 33, 33, 33, 33, 33, 33, 33, 33, 33, 33, 33, 2],
    [2, 33, 33, 2, 2, 2, 2, 2, 2, 2, 33, 33, 2, 33, 33, 2, 33, 33, 2, 2, 2, 2, 2, 2, 2, 2, 2, 2, 33, 33, 2],
    [2, 33, 33, 33, 33, 33, 2, 33, 33, 2, 33, 33, 2, 33, 33, 2, 33, 33, 33, 33, 33, 2, 33, 33, 33, 33, 33, 33, 33, 33, 2],
    [2, 33, 33, 33, 33, 33, 2, 33, 33, 2, 33, 33, 2, 33, 33, 2, 33, 33, 33, 33, 33, 2, 33, 33, 33, 33, 33, 33, 33, 33, 2],
    [2, 2, 2, 2, 33, 33, 2, 33, 33, 2, 33, 33, 2, 2, 2, 2, 2, 2, 2, 33, 33, 2, 2, 2, 2, 2, 2, 2, 33, 33, 2],
    [2, 33, 33, 2, 33, 33, 33, 33, 33, 2, 33, 33, 2, 33, 33, 33, 33, 33, 33, 33, 33, 2, 33, 33, 33, 33, 33, 2, 33, 33, 2],
    [2, 33, 33, 2, 33, 33, 33, 33, 33, 2, 33, 33, 2, 33, 33, 33, 33, 33, 33, 33, 33, 2, 33, 33, 33, 33, 33, 2, 33, 33, 2],
    [2, 33, 33, 2, 33, 33, 2, 2, 2, 2, 33, 33, 2, 33, 33, 2, 2, 2, 2, 2, 2, 2, 33, 33, 2, 33, 33, 2, 33, 33, 2],
    [2, 33, 33, 2, 33, 33, 2, 33, 33, 33, 33, 33, 2, 33, 33, 33, 33, 33, 33, 33, 33, 33, 33, 33, 2, 33, 33, 2, 33, 33, 2],
    [2, 33, 33, 2, 33, 33, 2, 33, 33, 33, 33, 33, 2, 33, 33, 33, 33, 33, 33, 33, 33, 33, 33, 33, 2, 33, 33, 2, 33, 33, 2],
    [2, 33, 33, 2, 33, 33, 2, 2, 2, 2, 2, 2, 2, 2, 2, 2, 2, 2, 2, 2, 2, 2, 2, 2, 2, 33, 33, 2, 33, 33, 2],
    [2, 33, 33, 33, 33, 33, 2, 33, 33, 33, 33, 33, 33, 33, 33, 33, 33, 33, 2, 33, 33, 33, 33, 33, 2, 33, 33, 2, 33, 33, 2],
    [2, 33, 33, 33, 33, 33, 2, 33, 33, 33, 33, 33, 33, 33, 33, 33, 33, 33, 2, 33, 33, 33, 33, 33, 2, 33, 33, 2, 33, 33, 2],
    [2, 33, 33, 2, 2, 2, 2, 2, 2, 2, 33, 33, 2, 2, 2, 2, 33, 33, 2, 33, 33, 2, 33, 33, 2, 33, 33, 2, 33, 33, 2],
    [2, 33, 33, 33, 33, 33, 33, 33, 33, 33, 33, 33, 2, 33, 33, 33, 33, 33, 33, 33, 33, 2, 33, 33, 33, 33, 33, 2, 33, 33, 2],
    [2, 33, 33, 33, 33, 33, 33, 33, 33, 33, 33, 33, 2, 33, 33, 33, 33, 33, 33, 33, 33, 2, 33, 33, 33, 33, 33, 2, 33, 33, 2],
    [2, 29, 29, 2, 2, 2, 2, 2, 2, 2, 2, 2, 2, 2, 2, 2, 2, 2, 2, 2, 2, 2, 2, 2, 2, 2, 2, 2, 2, 2, 2]
  ]
}