{
  "solidTiles": [16, 2, 2, 3, 18, 1],
  "start": [1, 0],
  "finish": [126],
  "data": [
    [1, 31, 31, 2, 2, 2, 2, 2, 2, 2, 2, 2, 2, 2, 2, 2, 2, 2, 2, 2, 2, 2, 2, 2, 2, 2, 2, 2, 1],
    [16, 31, 31, 31, 31, 2, 31, 31, 31, 2, 31, 31, 31, 31, 2, 31, 31, 31, 31, 31, 31, 31, 31, 31, 31, 31, 31, 31, 16],
    [1, 31, 31, 2, 2, 2, 31, 2, 2, 2, 31, 31, 3, 31, 2, 31, 2, 31, 31, 2, 2, 2, 2, 2, 2, 2, 31, 31, 1],
    [16, 31, 31, 2, 31, 31, 31, 2, 31, 31, 31, 31, 18, 31, 31, 31, 31, 31, 31, 31, 31, 31, 31, 31, 31, 2, 31, 31, 16],
    [1, 31, 31, 2, 31, 2, 2, 2, 31, 2, 2, 2, 2, 2, 2, 2, 2, 2, 2, 2, 2, 2, 2, 2, 31, 2, 31, 31, 1],
    [16, 31, 31, 2, 31, 31, 31, 31, 31, 2, 31, 31, 31, 31, 31, 31, 2, 31, 31, 31, 31, 31, 31, 31, 31, 2, 31, 31, 16],
    [1, 31, 31, 2, 31, 31, 31, 31, 31, 2, 31, 31, 31, 31, 31, 31, 2, 31, 31, 31, 31, 31, 31, 31, 31, 2, 31, 31, 1],
    [16, 31, 31, 31, 31, 2, 2, 2, 2, 2, 31, 31, 2, 2, 2, 2, 2, 31, 31, 2, 2, 2, 2, 2, 2, 2, 2, 2, 16],
    [1, 31, 31, 31, 31, 2, 31, 31, 31, 31, 31, 31, 2, 31, 31, 31, 31, 31, 31, 2, 31, 31, 31, 2, 31, 31, 31, 31, 1],
    [16, 31, 2, 2, 2, 2, 31, 2, 2, 2, 2, 2, 2, 31, 2, 2, 2, 2, 2, 2, 31, 3, 31, 2, 31, 2, 31, 31, 16],
    [1, 31, 31, 31, 31, 31, 31, 2, 31, 31, 31, 31, 2, 31, 31, 31, 2, 31, 31, 31, 31, 18, 31, 31, 31, 2, 31, 31, 1],
    [16, 2, 2, 2, 2, 2, 2, 2, 31, 3, 31, 31, 2, 2, 2, 31, 2, 31, 31, 2, 2, 2, 2, 2, 31, 2, 31, 31, 16],
    [1, 31, 31, 31, 31, 31, 31, 31, 31, 18, 31, 31, 31, 31, 2, 31, 2, 31, 31, 31, 31, 2, 31, 31, 31, 2, 31, 31, 1],
    [16, 31, 31, 2, 2, 2, 2, 2, 2, 2, 2, 2, 2, 31, 2, 31, 2, 2, 2, 31, 31, 2, 31, 2, 2, 2, 31, 31, 16],
    [1, 31, 31, 31, 31, 2, 31, 31, 31, 31, 31, 31, 2, 31, 2, 31, 31, 31, 2, 31, 31, 2, 31, 2, 31, 2, 31, 31, 1],
    [16, 31, 31, 31, 31, 2, 31, 31, 31, 31, 31, 31, 2, 31, 2, 31, 31, 31, 2, 31, 31, 2, 31, 2, 31, 2, 31, 31, 16],
    [1, 31, 31, 2, 2, 2, 31, 2, 2, 2, 2, 31, 2, 31, 2, 2, 2, 31, 2, 31, 31, 2, 31, 2, 31, 2, 31, 31, 1],
    [16, 31, 31, 31, 31, 2, 31, 31, 31, 31, 2, 31, 31, 31, 2, 31, 31, 31, 2, 31, 31, 2, 31, 2, 31, 2, 31, 31, 16],
    [1, 2, 2, 31, 31, 2, 2, 2, 31, 31, 2, 2, 2, 2, 2, 31, 2, 2, 2, 31, 31, 2, 31, 2, 31, 2, 31, 31, 1],
    [16, 31, 31, 3, 31, 31, 31, 2, 31, 31, 2, 31, 31, 31, 2, 31, 31, 31, 31, 31, 31, 2, 31, 2, 31, 2, 31, 31, 16],
    [1, 31, 31, 18, 31, 2, 2, 2, 31, 31, 2, 31, 31, 31, 2, 2, 2, 2, 2, 2, 2, 2, 31, 2, 31, 2, 31, 31, 1],
    [16, 31, 31, 31, 31, 2, 31, 31, 31, 31, 2, 31, 31, 31, 31, 31, 31, 31, 31, 31, 31, 2, 31, 31, 31, 2, 31, 31, 16],
    [1, 31, 31, 31, 31, 2, 31, 31, 31, 31, 2, 2, 2, 2, 2, 2, 2, 2, 2, 31, 31, 2, 31, 2, 2, 2, 31, 31, 1],
    [16, 2, 2, 2, 2, 2, 31, 3, 31, 31, 2, 31, 31, 31, 31, 31, 31, 31, 31, 31, 31, 2, 31, 2, 31, 31, 31, 31, 16],
    [1, 31, 31, 31, 31, 31, 31, 18, 31, 31, 2, 31, 31, 31, 31, 31, 31, 31, 31, 31, 31, 2, 31, 2, 31, 31, 31, 31, 1],
    [16, 31, 31, 31, 2, 2, 2, 2, 31, 31, 2, 31, 31, 2, 2, 2, 2, 2, 2, 2, 2, 2, 31, 2, 2, 2, 2, 2, 16],
    [1, 31, 31, 31, 31, 2, 31, 31, 31, 31, 2, 31, 31, 2, 31, 31, 2, 31, 31, 31, 31, 31, 31, 2, 31, 31, 31, 31, 1],
    [16, 31, 31, 31, 31, 2, 2, 2, 2, 2, 2, 31, 31, 2, 31, 346, 2, 31, 31, 2, 2, 2, 2, 2, 31, 2, 31, 31, 16],
    [1, 31, 31, 31, 31, 2, 31, 31, 31, 31, 2, 31, 31, 2, 31, 31, 2, 31, 31, 2, 31, 31, 31, 2, 31, 2, 31, 31, 1],
    [16, 31, 31, 2, 2, 2, 31, 31, 31, 31, 2, 31, 31, 31, 31, 31, 2, 31, 31, 2, 31, 31, 31, 2, 2, 2, 31, 31, 16],
    [1, 31, 31, 31, 31, 31, 31, 31, 31, 31, 2, 31, 31, 31, 3, 31, 2, 31, 31, 31, 31, 31, 31, 31, 31, 3, 31, 31, 1],
    [16, 31, 31, 31, 31, 31, 31, 31, 31, 31, 2, 31, 31, 31, 18, 31, 2, 2, 2, 2, 2, 2, 31, 31, 31, 18, 31, 31, 16],
    [1, 2, 2, 2, 2, 2, 2, 2, 31, 31, 2, 31, 3, 346, 0, 31, 2, 31, 31, 31, 31, 31, 31, 2, 31, 31, 31, 31, 1],
    [16, 31, 31, 31, 3, 31, 31, 31, 31, 31, 2, 31, 18, 31, 31, 31, 2, 31, 31, 31, 31, 31, 31, 2, 31, 31, 31, 31, 16],
    [1, 31, 31, 31, 18, 31, 31, 2, 2, 2, 2, 2, 2, 31, 31, 31, 2, 31, 31, 2, 2, 2, 31, 2, 2, 2, 31, 31, 1],
    [16, 31, 31, 31, 31, 31, 31, 31, 31, 31, 31, 31, 31, 31, 2, 31, 31, 31, 31, 2, 31, 31, 31, 2, 31, 31, 31, 31, 16],
    [1, 31, 31, 31, 31, 31, 31, 31, 31, 31, 31, 31, 31, 31, 2, 31, 31, 31, 31, 2, 31, 31, 31, 2, 31, 31, 31, 31, 1],
    [16, 2, 2, 2, 2, 2, 2, 2, 2, 2, 2, 2, 2, 2, 2, 2, 2, 2, 2, 2, 2, 2, 2, 2, 2, 2, 126, 126, 16]
  ]
}