{
"solidTiles": [2, 1, 21, 22],
  "start": [1, 1],
  "finish": [29],
  "data" : [
  [2, 2, 2, 2, 2, 2, 2, 2, 2, 2, 2, 2, 2, 2, 2, 2, 2, 2, 2, 2, 2, 2, 2, 2, 2, 2, 2, 2, 2, 2, 2, 1],
  [32, 32, 2, 32, 2, 32, 32, 32, 32, 32, 32, 32, 32, 32, 32, 32, 32, 32, 2, 32, 32, 32, 1, 32, 32, 32, 32, 32, 32, 32, 32, 16],
  [1, 32, 2, 32, 2, 32, 2, 2, 2, 2, 32, 2, 2, 2, 2, 2, 2, 32, 2, 32, 32, 32, 16, 32, 32, 2, 2, 2, 2, 2, 32, 1],
  [16, 32, 2, 32, 2, 32, 2, 32, 32, 2, 32, 2, 32, 32, 32, 32, 32, 32, 2, 32, 1, 32, 32, 32, 32, 2, 32, 32, 32, 2, 32, 16],
  [1, 32, 2, 32, 2, 32, 2, 17, 32, 2, 32, 2, 32, 2, 32, 32, 2, 2, 2, 2, 16, 2, 2, 2, 32, 2, 32, 1, 32, 2, 2, 1],
  [16, 32, 2, 32, 32, 32, 2, 32, 32, 2, 32, 2, 32, 2, 32, 32, 32, 32, 32, 32, 32, 32, 32, 32, 32, 2, 32, 16, 32, 32, 32, 16],
  [1, 32, 2, 2, 2, 2, 2, 32, 17, 2, 32, 32, 32, 2, 32, 32, 2, 2, 2, 2, 2, 2, 2, 2, 2, 2, 32, 2, 17, 32, 32, 1],
  [16, 32, 2, 32, 32, 32, 2, 32, 32, 2, 2, 2, 2, 2, 32, 2, 2, 32, 32, 32, 32, 32, 32, 32, 32, 32, 32, 2, 32, 32, 32, 16],
  [1, 32, 2, 32, 2, 32, 32, 32, 32, 2, 32, 32, 32, 32, 32, 2, 32, 32, 2, 32, 32, 32, 32, 32, 32, 32, 32, 2, 32, 2, 32, 1],
  [16, 32, 2, 32, 2, 2, 2, 2, 32, 2, 32, 2, 2, 2, 2, 2, 2, 2, 2, 2, 2, 2, 2, 2, 2, 2, 2, 2, 32, 2, 32, 16],
  [1, 32, 2, 32, 2, 32, 32, 32, 32, 2, 32, 2, 32, 32, 32, 2, 32, 32, 1, 32, 32, 32, 32, 32, 32, 32, 32, 2, 32, 2, 32, 1],
  [16, 32, 2, 32, 2, 32, 2, 2, 2, 2, 32, 2, 2, 2, 32, 2, 32, 32, 16, 32, 2, 2, 32, 2, 2, 2, 32, 2, 32, 2, 32, 16],
  [1, 32, 2, 32, 2, 32, 32, 32, 32, 32, 32, 32, 32, 32, 32, 2, 32, 32, 32, 32, 2, 32, 32, 2, 32, 32, 32, 2, 32, 2, 2, 1],
  [16, 32, 2, 32, 2, 2, 2, 32, 32, 2, 2, 2, 2, 2, 2, 2, 32, 2, 2, 2, 2, 32, 32, 2, 2, 2, 2, 2, 32, 32, 32, 16],
  [1, 32, 32, 32, 32, 32, 2, 2, 2, 2, 32, 32, 32, 32, 32, 32, 32, 32, 32, 32, 2, 32, 32, 2, 32, 32, 32, 2, 17, 32, 32, 1],
  [16, 32, 1, 32, 1, 32, 32, 32, 32, 32, 32, 32, 32, 2, 2, 2, 2, 32, 32, 32, 2, 32, 1, 32, 32, 2, 32, 2, 32, 32, 32, 16],
  [1, 32, 16, 17, 16, 2, 2, 2, 2, 2, 2, 2, 2, 32, 32, 32, 2, 2, 2, 2, 2, 32, 16, 32, 17, 2, 32, 2, 32, 32, 32, 1],
  [16, 32, 32, 32, 32, 2, 32, 32, 32, 32, 32, 32, 32, 32, 32, 32, 32, 32, 32, 32, 2, 32, 32, 32, 32, 2, 32, 2, 32, 32, 32, 16],
  [1, 32, 2, 2, 32, 2, 32, 32, 32, 32, 32, 32, 32, 2, 2, 2, 2, 2, 2, 32, 2, 32, 2, 2, 2, 2, 32, 2, 32, 2, 2, 1],
  [16, 32, 2, 32, 32, 2, 32, 2, 32, 32, 1, 32, 32, 32, 32, 32, 32, 32, 32, 32, 2, 32, 2, 32, 32, 2, 32, 2, 32, 32, 32, 16],
  [1, 32, 2, 32, 2, 2, 32, 2, 32, 32, 16, 32, 32, 32, 2, 2, 2, 2, 2, 2, 2, 32, 2, 32, 32, 2, 32, 2, 17, 32, 32, 1],
  [16, 32, 2, 32, 32, 2, 32, 2, 32, 32, 2, 2, 2, 2, 2, 32, 32, 32, 32, 32, 32, 32, 2, 32, 32, 2, 32, 32, 32, 32, 32, 16],
  [1, 2, 2, 2, 32, 2, 32, 2, 32, 32, 32, 32, 32, 32, 32, 32, 1, 32, 32, 32, 32, 32, 2, 32, 32, 2, 2, 2, 32, 32, 32, 1],
  [16, 32, 32, 32, 32, 2, 32, 2, 32, 32, 32, 32, 32, 2, 2, 2, 16, 2, 2, 32, 2, 32, 2, 32, 32, 32, 32, 2, 2, 2, 2, 16],
  [1, 32, 2, 32, 32, 32, 32, 2, 2, 2, 2, 2, 32, 32, 32, 32, 32, 32, 2, 32, 2, 32, 2, 32, 32, 32, 32, 32, 32, 32, 32, 1],
  [16, 32, 2, 32, 2, 2, 2, 2, 32, 32, 32, 2, 2, 2, 2, 32, 32, 32, 2, 32, 2, 32, 2, 32, 32, 32, 2, 2, 2, 32, 32, 16],
  [1, 32, 2, 32, 32, 32, 32, 32, 32, 32, 32, 2, 32, 32, 32, 32, 32, 32, 2, 32, 2, 32, 2, 32, 32, 32, 32, 32, 2, 32, 32, 1],
  [16, 32, 2, 32, 32, 32, 2, 2, 2, 2, 2, 2, 32, 2, 2, 2, 2, 2, 2, 32, 2, 2, 2, 32, 32, 2, 2, 2, 2, 32, 32, 16],
  [1, 32, 2, 32, 32, 32, 2, 32, 32, 32, 32, 32, 32, 2, 32, 32, 32, 32, 32, 32, 2, 32, 32, 32, 32, 2, 32, 32, 32, 32, 32, 1],
  [16, 32, 2, 2, 2, 2, 2, 32, 32, 2, 2, 2, 2, 2, 32, 32, 32, 32, 2, 2, 2, 32, 2, 2, 2, 2, 32, 32, 32, 1, 32, 16],
  [1, 32, 32, 32, 32, 32, 32, 32, 32, 2, 32, 32, 32, 32, 32, 32, 32, 32, 32, 32, 32, 32, 2, 32, 32, 32, 32, 32, 32, 16, 32, 29],
  [16, 2, 2, 2, 2, 2, 2, 2, 2, 2, 2, 2, 2, 2, 2, 2, 2, 2, 2, 2, 2, 2, 2, 2, 2, 2, 2, 2, 2, 2, 2, 29]
]
}